D
25 20








##############  #########
.....z......z#  #z.......
###########..####..######
          ##......##
           ########

######                ###
@...z#                #.E
###..######      ######.#
  #z.....z########..r...#
  ######...............#
       #################
