D
53 30
####################                 #........r.....#
#..@...r...*.**.***#                 #......#########
#.##.############.*#######           ######....rm#
#....#          #*...*.**############*..m.....###
#..###           #####*.*s*#**s#**s*#.#########
#r.#                 #####*s*#*s*##*s*#
#..#                     #############






















         .