25 20

       #############
      ##............#
    ###...o...##.....#
   #.........# ###....#
   #...#####.#  #..o..#
   #..##  #..#  #......#
   #.##   #mm#  #....o.#
###...#    ##   #......#
E...##       ###....o...#
#####     ###..b........#
       ###.....####.....#
      ##.....##   #######
      #....###
######....#
@........#
#########



