D
25 20








##############  #########
E....z......z#  #z......@
###########..####..######
          ##......##
           ########
             
######                ###
....z#                #..
###..######      ######.#
  #z.....z########......# 
  ######...............#
       #################
